22222222222222222222222222
20000000000000000000000002
20000010000010000100000002
20000010000000000000000002
20E00011100000000000000002
20000010000000000010000002
20000000000010000000000002
20P00000000000000010000002
20000000100000000000000002
20010000100000000000000002
20000000100000001110000002
20000000100000001000000002
22222222222222222222222222