11111111111111111111111111
1P000000C1000C0001C11101C1
111110110101111101010C0101
10000001000100000000000001
1C100001110001111100111111
11100001000001C00100101C01
10000001001111000000001001
10101001C00001111001100001
101010011110000C1000111111
1C1C10000000011110000000E1
11111111111111111111111111