11111111111111111111111111
10000000010000000C10000E01
1001000001C000000010000001
10011100011111000010000001
1001C100000000000010000001
1P010100000001111110000001
11110100C00001000000000001
10C1000000000100C000111111
1001110000000100000010C001
10000000000000000000000001
11111111111111111111111111